5 13 31
###############################
#p *#*       f*  ** * *x     *#
#   # # #*# # #*# # # # # #*# #
# s  * * *#* *b      *   f**  #
# ### # # # # # #b# # # # # #*#
#    x     *     **      *  **#
# # #*# # # # # #*#*#*#*# # # #
#   *sb      *   * *x* *      #
# # # # #*# # # # # # #*# #*# #
#   ****         *            #
##### # # #***  # #*# # # # #*#
#  ** *   *                   #
###############################