3 13 31
###############################
#p #  ** # 3 *s* # **f ## ** b#
#    s*  *    #  #      #     #
#  #*b*  #  **# **   *s*   #  #
#  # # # **#b*# # #  #   # #  #
#**  # # # #    1    #**      #
##*****#   #*** # #      #** ##
#  # # #**   #   **      fb   #
#    ******##  ***  **f*      #
#  # #  2   #   *   *   ** ####
#  # #  *   #   *   b   #     #
#  # #      #   # **#   #     #
###############################