3 13 31
###############################
#p #  ** #   *s* # **f ## ** b#
#    s*  *    #  #      #     #
#  #*b*  #  **# **   *s*   #  #
#  # # # **#b*# # #  #   # #  #
#**  # # # #x        #**      #
##*****#   #*** # #      #** ##
#  # # #**   #   **      fb   #
#    ******##  ***  **f*      #
#  # #      #   *   *   ** ####
#  # #  x   #   *   b   #     #
#  # #      #   # **#   #   x #
###############################