4 13 31
###############################
#p #  # *#   *   *   #   *    #
#      **s   *   s*  f     *  #
########################***####
# ## # bf   *#####bs   **  *  #
#  *** # #  *     *####  #    #
#  # ****   #  * **   ####**f##
#  # # #  # #*###*    #    #  #
####   *x    *   **####   b   #
#   * * *  #     *    # ***x**#
####*# **# # #  **  #  # # #  #
#x   #    ** *   *   *   *    #
###############################