2 13 31
###############################
#p * *       bx  ** * *      *#
# # # # #*# # #*# # # # # #*# #
#    * * *** **      *    **  #
# #*# # # # # # #b# # # # # #*#
#       x  *     **  b   *  **#
# # #*# # # # # #*#*#*#*# # # #
#   *f   s   *   * *x* *      #
# # # # #*# # # # # # #*# #*# #
#   ****         *            #
# # # # # # # # # #*# # # # #*#
#  ** *   *                   #
###############################