2 13 31
###############################
#p x* *       b  ** * *      *#
# # # # #*# # #*# # # # # #*# #
#    * * *** **   2  *    **  #
# #*# # # # # # #b# # # # # #*#
#       b*  *     **     *  **#
# # #*# # # # # #*#*#*#*# # # #
#   *f   s   **     ** *      #
# # # # #*# # # # # # #*# #*# #
#   ****         *            #
# # # # # # # # # #*# # # # #*#
#  ** *   *   3               #
###############################